22222222214441222222222
22222222214441222222222
22222222214441222222222
22222222214441222222222
22222222214441222222222
22222222214441222222222
22222222214441222222222
22222222214441222222222
22222222214441222222222
11111111114441111111111
44444444444444444444444
44444444444444444444444
44444444444444444444444
11111111114441111111111
22222222214441222222222
22222222214441222222222
22222222214441222222222
22222222214441222222222
22222222214441222222222
22222222214441222222222
22222222214441222222222
22222222214441222222222
22222222214441222222222
