22222222214441222222222
22222222214441222222222
22222222214441222222222
22222222214441222222222
22222222214441222222222
22222222214441222222222
22222222214441222222222
22222223333333332222222
22222223333333332222222
11111113300000331111111
44444443300000334444444
44444443300000334444444
44444443300000334444444
11111113300000331111111
22222223333333332222222
22222223333333332222222
22222222214441222222222
22222222214441222222222
22222222214441222222222
22222222214441222222222
22222222214441222222222
22222222214441222222222
22222222214441222222222
