11111114441022222
14444444441022222
14444444441022222
14444444441022222
14441114441022222
14441014441022222
14441014441011111
14441014441014444
44441014441014444
44441014441014444
22222014441014441
22222014441014441
22222014441114441
22222014444444441
22222014444444441
22222014444444441
22222014441111111