22222222222222222
22222222222222222
22000222222222222
22000022222222222
22200002222222222
22220002222222222
22222222222222222
22222223332222222
22222223332222222
22222223332222222
22222222222222222
22222222220002222
22222222220000222
22222222222000022
22222222222200022
22222222222222222
22222222222222222