11111111111111111
11111111111111111
11111111111111111
11111111011111111
11113333033331111
11113333033331111
11113333333331111
11113333333331111
11100033333000111
11113333333331111
11113333333331111
11113333033331111
11113333033331111
11111111011111111
11111111111111111
11111111111111111
11111111111111111